121111111111111111111111111111111111111111111111111111111111111111111111111111111
122212122212122122222211212122221221212111221122212121111212222222222112221122111
121212121112221211211222222212122212222221122221212222222221211212112112112212111
111212121122111221211211212122111212111211212121212111121212212112212112222122221
122222222221112122122211112111121222222122212111212122222121122212122222112221211
112112111212122212121121222222222121112121212221211111212121221112121121221212221
112212121122121222112222121121212112112221121212222221211122122212212221122221121
122122122221122122211211212122122222112122222212121212212112121111211121112112111
121112222122221221112222212211211212222111112122211121222212222222221122221122221
121121212211211111112111122112221111211112212111112121211112111211122121112221121
112222211222121211222221221221121221222221212221212222222222122211121212221211121
121211122211221212112122122122221121211111211212211211121121221111222212112212221
122222211221212212122211121211122222212211222211222221221221211222212222112112111
112111212211211222112122222222221211222112221122212121211122122112112112222111121
122212111211221211122221212112112211112122122221211112122121212112122111212221221
111212121222122211121121212112111222211212211121222212121211212221212211211211211
122122222212112121121122112221121212122222112212112112222222211211221121221212211
112112112112112222222121221111222221121112112122122222121111222222211222212212121
112211121222111211211221212221121112111112222212221212212211112111212121211222221
122112221122221112212212212122122112221211212121112221212112112112212122111112121
112121122221121112111221222211212212122221221221222122122222212212112221111112121
112121221111121222221121212122222122112112112121212112112111221212122111122211221
122222211121121111211121112212111221112112112122211222211211121221111221111221121
121211112222212211212221222112122122112222112221122211222221122211121122122121111
112222122112111212212122112212221121112122211111121212211121212122222121212222221
122112121221112222122212111222122221222121212222221121112111221112121222211211211
112121122211212112211212211212212111121121111112122221222222211211121211122221221
122122112111222211122121122121212111111222121112211211121121111221122222111122111
121121112112121211121121112222111121121111122212112211121122211122121112221212221
122222222212112222221222222111211222222121212112221212222121121121112111122212121
112121121222112112121211211111212121212221222212111112121121121222222122221222121
122112212112112212122121221111222221111121211212122122121221221112111212111112111
121211212222212112111121212122212111212122211212212121121112121222122222222212121
121211222121212211212121212121211222212112222111212221121212121112111211121111121
111222211211211222212222212112221112112122112122221222121222121222122212222222221
121211222222112111222111112212112222222212121111121111121211121211121212111112121
122221212111122211212221222112111211121222122212122222222222221212121212121222121
112121221111211221211111112111121112121211121112111211111112111212121211121211111
111222122111212212222122222212222212221222222212122212122212221212221212222212121
122212121122212111121211121211121112111212111112121212121211121212111111111212121
112112121221222212221222221212221222121212221222221222221222121222121212222222221
121121221112121211121212111112111112121112111112111111111111111112121211121111121
121222121222121222122212222212221222121222222222122212221222122222222212222212121
121211121211111212111211111112121111121211121212111212111112111212111111111212111
122222221222221212122212222222122222222212221212222222221222221212121222221222221
111211111212111112121212111111111211111211111211121112111112121112121211111111121
121212221212222222121212221212222222121212221212121222221222122222221222122222221
121212121111121211121111111211121112121212111212121112111111111211111112111112111
122222122212221222222222221222221222221222122212121222122222122222221222121222221
111111121112111112111112111212111111121211111112111212121211111211111212121111121
121222122212122222122222121212121222221222221212221212121212122222122212121212121
121112121111121211121112121111121111121112111212111211121212111211111211121212111
122222221222121222121222221222122222222212122222122222221222221222221222221222121
111211111112111211111111111112111111111211121212111212111111111111121211121211121
122222222222221212222222222212221222122222121212222212121222121222222212222222221
111112111211111212111111111212121211111112111211121112121112121111121212111212121
122212122222122212122222121212122222221222122212221222121222221212121212121212121
111211111211121112121112121112111112111211121111121211121112111212111112121112121
122222122222221212121212221222222212222222122212221212122222122222121212221222121
121211121111111212121211121111111111111112121112111212111211111211121212121112111
121222221212221222221222222222122222122212122212122222122222122222222222122212121
121112111212111211111111111211121112121212111112111111121211121111121211111112121
121222122222121222121212221222221222221222122212122212221212221222221222221212221
111111121111121211121212111211121111111211121112111211111211121111111111121211121
121212221222222222222212222212222212221222221222221212221222121222122222121222221
121211121111121111111111121111111112121112121112111212111112121212111212121111111
122222222222221212222212122222222212122212121222221222121212221212122212122212221
111111111211121212121212111212111111111212111111111212121212111212111211121112111
121212121212221222121222221212222222222212222212222212222222122212122212221222121
121212121111121212121212111112111112121211121211111112121111111112111211121211121
122212121222121212121212221222122222121212121222121212121222222212221212222222121
111212121211121112121112121111111111121112121111121211121211111112111212121212121
122212122222221222121212122212221222122212222222122212222212221212222211111221121
111212111211111212111211121212111212121111121112121211111212111212112112222222221
122222222222122212221212121212222212122222122212121222121222121212121122111111211
111111111112111212121212111211111211121111111211121111121121122222221121122222221
122222122222222212121222222212221222122222221212122212122222212121111221222211221
121112111211111111111211121111121112121111111112211222111222212111122112111112211
122212222212221222122212222212222222221222121221221222222121222222121112222222221
111111121111121112121212111112111112121112121122211211112211211112121222121211121
122222122212222212221212122222221221212222222221112212211222121122122221122112211
121112111212121111111211121211122212222212222211222212221221122212122211221121221
121212122222122212122112121212112112211122111221221112111111222222212212221222121
111212111111111122221212222112222122112222221121222222112222211221221211121222221
122222222212221112112221211221112111122211122122211221122122112121122112121111211
111112112121122222221122211211212111121222112212221111221121122122112222122222221
121221122221211221222122222211212222221122112212212221211212221122221212212222121
121212211211211211111121111212211222112111121112122211211211212211111221221211221
121222112212221212222211222211221112122121222122112222122212212112222221212122211
122222222212211221221212221221122222221121121211222122212112122222212122112221121
111111212212111212211222112222122222111222122211122112112112212111121222112121221
112222212112112211112221122122121111122112222222222121122211211122222211221122211
122111221122222112212211222121121122221121221221211122121222222221111122121212111
121121122222211122112122211121211221221222221111212222221121111111122122121212221
121222112211212221122122112222222211221221221122211221222121112212222122121212221
112112211122222121221222122222222122212211212221212211111221222222112221122222221
122211222221112122222112112111111112112112221211222112222211221122112112121212221
111221112211211121112211221122222222122112212112221122222112222122121112221112211
121222211212221222121222122221122111121122122222111211111122112212121222222112111
121211221121221222221121211121111212121221122211112212222221112121222211112122121
122211121222221111122122212112222222121212221122222221122211222221122222221121221
112222122122112112112112212211121221221121221222111222212112111222221222211121121
122111121222112222212212122222111212221222221112221112221122121121211112122222121
121111222222112112211212112222221212221222112211222211122221122111122222212112221
122222122111222121121221122111222222122112112211111222111122222222112211121212211
121222112121121122121122221222221222122211122122112112222112111222122112222221221
122112211221221222121111221221221222112211221221122211122212122121121222111211221
122211221122211221222112211211221221121122211211122222112212112121221212122112221
111221122222112211222121212211221221222222212211221222121112212222221221221121121
121122121121122222221122122221122122122111222112112211221121121222222122122122211
122121221221222121121221221122122122122221122122212222211222121212112222212212121
121221221221211122112211212212122121221122122112222221122211221111212211222212121
121221211211211212112112212112111121121122111222222122112112212222222221221222221
122211212212212222222122212212212122221112122121122112212111222211221111221222221
122112112222212211222212222211222211211211221222112211122221211211121122122222211
122122122212212221111211211221122112211212121121121222221122221122122221122122211
112122122112211222221221221122121122112222221221221222111211222122121211122222221
112112221122111112212222222112122122122212211212221211122222212221111222212121121
121122121222112221111111222112122122212222222212112212221112211221221222211121221
122221221211122222222122212122112112221122112212122212211211221122221212221211121
122212222112221112122221211221122221221112212222111122212222212221111221122222121
111111111111111111111111111111111111111111111111111111111111111111111111111111121
